0
2 2
8 9
16
0 0 4 0
4 0 4 15
4 15 15 15
15 15 15 4
15 4 10 4
10 4 10 11
10 11 6 11
6 11 6 0
6 0 19 0
19 0 19 19
19 19 0 19
0 19 0 0
10 2 15 2
15 2 15 3
15 3 11 3
11 3 10 2
0
0
1
-1 -1 5 -1 5 14 14 14 14 5 11 5 11 12 5 12 5 -1 20 -1 20 20 -1 20
1
10 2 15 2 15 3 11 3
1
0 0 4 0 4 15 15 15 15 4 10 4 10 11 6 11 6 0 19 0 19 19 0 19
2
0 7 2 7 4 9 4 12 2 12 0 10
17 15 19 15 19 19 15 19 17 17
3
0 17 2 17 2 19 0 19
17 0 19 0 19 2 17 2
6 0 8 0 8 2 6 2