0
4 13
15 11
16
2 2 8 2
8 2 8 7
8 7 2 7
2 7 2 2
11 2 17 2
17 2 17 7
17 7 11 7
11 7 11 2
2 9 9 9
9 9 9 15
9 15 2 15
2 15 2 9
10 9 17 9
17 9 17 15
17 15 10 15
10 15 10 9
0
4
7 4
13 4
7 10
12 14
3
1 1 9 1 9 8 1 8
10 1 18 1 18 8 10 8
1 8 18 8 18 16 1 16
0
4
2 2 8 2 8 7 2 7
11 2 17 2 17 7 11 7
2 9 9 9 9 15 2 15
10 9 17 9 17 15 10 15
2
2 5 4 5 4 7 2 7
15 12 17 12 17 14 15 14
2
14 4 16 4 16 6 14 6
7 13 8 13 9 15 7 15